q IQN  |l|  QSL i
e OEK  |i|  VEY j
a ZAD  |n|  MCZ q
b ZUT  |k|  LYN g
u CND  |e|  HSB j
k OIX  |d|  KBF h
d XJV  |l|  GZV m
g ZAG  |i|  LQZ x
v CJA  |s|  ACF l
q KWG  |t|  IDC j
